###############################
#  b *3       *  ** * *      *#
# # # # #*# # #*# # # # # #*# #
#  s * * *** **      *    **  #
# #*# # # # #f# #b#2# # # # #*#
#        1  *     **      *  *#
# # #*# # #*# # #*#*#*#*# # # #
#   *        *   * *x* *      #
# # # # #*# #*# # # # #*# #*# #
#   ****           1          #
# # # # # #*#*# # #*# # # # #*#
#  ** *   *    2         1    #
###############################