###############################
#   b** **    *               #
# # # #*# # # # # # # # # # # #
#*     **l* *  *   * b*   *   #
# # # # # #*# # # # # # #*# # #
#*   *s*    *** *   **   1    #
# # # # # # # # # # # # # #*# #
#   *a     *        *    **   #
# #*# # #*#*#*#*# # # # # #*# #
#        *   * *    *   *     #
#*# # # # # # #  ## # #*# # #*#
# *    *o**    **d***         #
###############################