###############################
#  * *        *  ** * *      *#
# # # # #*# # #*# # # # # #*# #
#    * * *** **      *    **  #
# #*# # # # # # #b# # # # # #*#
#           *     **      *  *#
# # #*# # # # # #*#*#*#*# # # #
#   *        *   * *x* *      #
# # # # #*# # # # # # #*# #*# #
#   ****         *            #
# # # # # # # # # #*# # # # #*#
#  ** *   *              1    #
###############################